NO j
SO j
EA j
WE j
F 0,0,0
C 0,0,0

11111
1ND01
11111
