NO ./textures/pack2-1024/Dark/texture_13.png
SO ./textures/pack2-1024/Green/texture_01.png
WE ./textures/pack2-1024/Red/texture_01.png
EA ./textures/pack2-1024/Orange/texture_01.png

F 173,165,135
C 135,206,235

11111111111111111111111111
1111111N111111001111110111
10000000000000000000000001
10000010000000000000010001
10000000000000000000000001
10000010101000000000010101
100000111D10000000000111D1
10000010001000000000010001
10000010001000000000010001
10000011011000000000011011
11110111011111001110111011
1111D111D1111100111D111D11
11110110011111001110110011
10000000000000000000000001
10000010000000000000010001
10000000000000000000000001
11111111111111111111111111
