NO ./textures/pack1-1024/wall.png
SO ./textures/pack1-1024/wall.png
WE ./textures/pack1-1024/wall.png
EA ./textures/pack1-1024/wall.png

C 0,0,0
F 0,0,0

      11111111111111111111111111
        1111111N1111110011111111
1111111110000000000000000001
1000001000000000000001000111
10000000000000000000000001
10000010101000000000010101
100000111D10000000000111D1111111111111111111
10000010001000000000010000000000000000000001
11111111110000000000000011111111111111111111
        1110000011001000000000011011
1111111111111100111011101110000010011111111111111111
1100011001111100111D111D1111110111011111001110111011
111101100000000011101100111111D111D1111100111D111D11
1000000001111000000000000111110110011111001110110011
1001001001  1000000010000D00000000000000000000000011
1000000001  1100000000000110000010000000000000010011
111111111111 111111111111111111110000000000001111111
                          10000000000000000000000001
                          11000000000000000000000001
                          11000000000000000000000001
                          11000000000000000000000001
1111111111111111111111111111000000000000000000000001
1000001000000000000000000000000000000000000000000001
1000000000000000000000000111111111111111111111111111
10000010101000000000010101
100000111D10000000000111D1111111111111111111
10000010001000000000010000000000000000000001
11111111110000000000100011111111111111111111
        1110000011011000000000011011
1111111111111100111011101110000010011111111111111111
1100011001111100111D11101111110111011111001110111011
1111111111111111111111111111111111111111111111111111
