NO ./textures/pack2-1024/Dark/texture_13.png
SO ./textures/pack2-1024/Green/texture_01.png
WE ./textures/pack2-1024/Red/texture_01.png
EA ./textures/pack2-1024/Orange/texture_01.png

F 3,45,0
C 193,30,51

11111
10001
10001
100N1
11111