F 0,0,0
C 0,0,0
NO baard
SO baard
WE baard
EA baard

1111
1W01
1101