NO ./textures/pack2-1024/Dark/texture_13.png
SO ./textures/pack2-1024/Green/texture_01.png
WE ./textures/pack2-1024/Red/texture_01.png
EA ./textures/pack2-1024/Orange/texture_01.png

F 76,100,0
C 65,30,0

111111111111111
111111101111111
100000000000001
100000100000001
100000000000001
1000001N1010001
100000111010001
100000100010001
100000100010001
100000110110001
111111111111111